border_size=1
usage=map

Gs^Fp       , Gs^Fp       , Re^Dr       , Gs^Fp       , Re          , Gg          , Re          , Gs^Fp       , Gg          , Gg          , Gg          , Gg          , Gg          , Gg          , Gg          , Gg          , Re          , Re          , Gg          , Gg          , Gg          , Gg          , Gg          , Gg          , Gs^Fp       , Re          , Re          , Gs^Fp       , Gs^Fp       , Gs^Fp       , Gs^Fp       , Gg          , Gs^Fdw      , Gs^Fp       , Gs^Fp       , Gg          , Gg          , Gg          , Gs^Fdw      , Gg          , Gg          , Gg          , Gg          , Gg          , Gg          , Gg          , Gg          , Gg          , Gg          , Gg          , Gg          , Gg          , Gg          , Gg          , Gg          , Gg          , Gg          , Gg          , Gg          , Gg          , Gg          , Gg          
Gs^Dr       , Chr         , Khr         , Chr         , Re          , Re^Dr       , Re          , Gg          , Gg          , Re^Vct      , Gg          , Gg          , Gg          , Gg          , Ce          , Ce          , Ce          , Re          , Re          , Gg          , Gg          , Gg          , Gg          , Gg          , Gs^Fdw      , Gs^Fp       , Re          , Gg          , Re          , Gs^Fp       , Re          , Gs^Fp       , Gg          , Gs^Fdw      , Gg          , Gg          , Gg          , Gg          , Gs^Fp       , Gs^Fdw      , Gg          , Gg          , Gg          , Gg          , Gg          , Gg          , Gg          , Gg          , Gg          , Gg          , Gg          , Gg          , Gg          , Gg          , Gg          , Gg          , Gg          , Gg          , Gs^Fdw      , Gs^Fp       , Gg          , Gg          
Gs^Fp       , Chr         , Chr         , Re^Dr       , Gs^Fp       , Gs^Fdw      , Gs^Fdw      , Gg          , Gg          , Gg          , Gg          , Gg          , Gg          , Ce          , Ce          , 3 Ke        , Ce          , Re          , Re          , Re          , Gg          , Gg          , Gg          , Gg          , Gg          , Gg          , Gg          , Gg          , Ds          , Re^Vct      , Gs^Fp       , Gs^Fp       , Gs^Fp       , Gg          , Gg          , Gg          , Gg          , Gg          , Re          , Re          , Gg          , Gg          , Gg          , Gg          , Gg          , Gg          , Gg          , Gg          , Gg          , Gg          , Re          , Gg          , Gs^Fdw      , Re          , Re^Vct      , Gg          , Gg          , Gg          , Gg          , Gg          , Gg          , Gg          
Gs^Fp       , Chr         , Gs^Dr       , Ggf         , Gs^Fp       , Gs^Dr       , Gg^Vl       , Gg          , Gg          , Gg          , Gg          , Gg          , Gg          , Ce          , Re          , Ce          , Re          , Re          , Gs^Fp       , Gg          , Ds          , Ds          , Ds          , Ds          , Ds          , Gg          , Ds          , Ds          , Ds          , Ds          , Ds          , Gs^Fdw      , Ds          , Gs^Fdw      , Gs^Fdw      , Gg          , Gg          , Gg          , Gg          , Gg          , Gg          , Gg          , Gg          , Gg          , Gg          , Gg          , Gg          , Gg          , Re          , Re          , Re          , Gs^Fdw      , Gs^Fp       , Re          , Re          , Re          , Gg          , Gg          , Gg          , Gg          , Gg          , Gg          
Gs^Fp       , Gs^Fp       , Gs^Fp       , Gs^Fdw      , Gs^Fdw      , Gs^Fdw      , Gs^Fp       , Gg          , Gs^Fp       , Gg          , Gg          , Gg          , Gg          , Gg          , Gg          , Re          , Re^Vct      , Re          , Gg          , Gg          , Gg          , Ds          , Ww          , Ww          , Ww          , Ds          , Ww          , Ww          , Ww          , Ww          , Ww          , Ds          , Ww          , Ds          , Ds          , Gg          , Gg          , Gg          , Gg          , Gg          , Gg          , Gg          , Gg          , Gg          , Gg          , Gg          , Gg          , Gg          , Gg          , Re          , Gs^Fp       , Gs^Fp       , Gs^Fp       , Re          , Re          , Re          , Ce          , Gg          , Gg          , Gg          , Gg          , Gg          
Ss          , Ss          , Gs^Fp       , Gs^Fp       , Gs^Fdw      , Gs^Fp       , Gs^Fp       , Gs^Fdw      , Gs^Fp       , Gg          , Gg          , Gg          , Gg          , Gg          , Gg          , Gg          , Gg          , Gg          , Gg          , Gg          , Ds          , Ds          , Ww          , Ww          , Ww          , Ww          , Ww          , Ww          , Ww          , Ww          , Ww          , Ww          , Ww          , Ds          , Ds          , Gg          , Ds          , Gg          , Gg          , Gg          , Gg          , Gg          , Gs^Fdw      , Gs^Fp       , Gg          , Gg          , Gg          , Gg          , Gg          , Gs^Fp       , Gs^Fp       , Gs^Fp       , Gs^Fp       , Re          , Ce          , Ce          , Ce          , Ce          , Re          , Gg          , Gg          , Gg          
Ss          , Ss          , Gs^Fdw      , Gs^Fp       , Gs^Fdw      , Gs^Fp       , Gs^Fdw      , Gs^Fp       , Gg          , Gg          , Gg          , Gg          , Gg          , Gg          , Re          , Re          , Gg          , Gg          , Gg          , Ds          , Ww          , Ww          , Ww          , Ww          , Ww          , Ds          , Ds          , Ww          , Ww          , Ww          , Ww^Vm       , Ww          , Ww          , Ww          , Wwf         , Ds          , Ds          , Ds          , Ds          , Gg          , Gg          , Gg          , Gg          , Gg          , Gg          , Gg          , Gg          , Gg          , Gg          , Gg          , Gs^Fp       , Gs^Fdw      , Gg          , Re          , Ce          , 2 Ke        , Ce          , Re          , Gg          , Gg          , Gg          , Gg          
Gs^Fdw      , Gs^Fp       , Gs^Fp       , Gs^Fp       , Gs^Fp       , Gg          , Ss          , Gs^Fp       , Gg          , Gg          , Re          , Gg          , Gg          , Gg          , Re          , Gg          , Gg          , Gg          , Ds          , Ds          , Ww          , Ww          , Ww          , Ww          , Ds          , Ds          , Ww          , Ww          , Ww          , Ww          , Ww          , Ww          , Wo          , Ww          , Ww          , Wwf         , Ww          , Ww          , Ds          , Ds          , Gg          , Gg          , Gg          , Gg          , Gg          , Gg          , Gg          , Gg          , Gg          , Gg          , Gs^Fp       , Gs^Fp       , Gs^Fp       , Re          , Re          , Ce          , Ce          , Re          , Re          , Gg          , Gg          , Gg          
Gs^Fdw      , Gs^Fp       , Ss          , Ss          , Ss          , Gs^Fdw      , Ss          , Gs^Fdw      , Re          , Gg          , Gg          , Re          , Gg          , Re          , Gg          , Gg          , Gg          , Gg          , Gg          , Ds          , Ww          , Ww          , Ww          , Ww          , Ww          , Ww          , Wo          , Wo          , Ww          , Ww          , Ds          , Ww          , Wo          , Wo          , Wo          , Ww          , Ww          , Ww          , Ds          , Ds          , Gg          , Gg          , Gg          , Gg          , Gg          , Gg          , Gg          , Gg          , Gg          , Gg          , Gg          , Gg          , Gg          , Gg          , Gg          , Re          , Re          , Gg          , Gg          , Re^Vct      , Gg          , Gg          
Gs^Fp       , Ss          , Ss          , Ss          , Cud         , Ss          , Ss          , Ss          , Ss          , Re          , Re          , Gs^Fp       , Gg          , Gg          , Gg          , Gg          , Gg          , Gg          , Ds          , Ds          , Ww          , Ww          , Ww          , Ww          , Ww^Vm       , Ww          , Ww          , Wo          , Ww          , Dd^Vdt      , Ww          , Ww          , Ww          , Ww          , Wo          , Ww          , Ww          , Ww          , Ds          , Re^Vct      , Ggf         , Gg          , Gg          , Gg          , Gg          , Gg          , Gg          , Gg          , Gg          , Gg          , Gg          , Gg          , Gg          , Gg          , Gg          , Gs^Fp       , Gs^Fp       , Gg          , Gs^Fp       , Gg          , Gg          , Gg          
Gs^Fdw      , Ss          , Ss          , Cud         , Cud         , Cud         , Cud         , Ss          , Ss          , Gs^Fdw      , Ss          , Gs^Fdw      , Gs^Fdw      , Gg          , Gg          , Gg          , Ds          , Ds          , Ds          , Ds          , Ww          , Ww          , Ww          , Ww          , Ww          , Ww          , Wo          , Ww          , Wo          , Ww          , Ww          , Ww          , Ww          , Ww          , Ww          , Ww          , Ww          , Ds          , Ce          , Ggf         , Ce          , Gg          , Gg          , Gg          , Gg          , Gg          , Gg          , Gg          , Gg          , Gg          , Gg          , Gg          , Gg          , Gg          , Gs^Fp       , Gs^Fp       , Gs^Fp       , Gs^Fdw      , Gs^Fp       , Gg          , Gg          , Gg          
Gs^Fdw      , Ss          , Ss          , Cud         , Cud         , 4 Kud       , Cud         , Ss          , Gs^Fdw      , Ss          , Ss          , Gs^Fdw      , Ds          , Re          , Ds          , Ds          , Ds          , Ds          , Ww          , Ww          , Ww          , Wo          , Wo          , Wo          , Wo          , Wo          , Wo          , Wo          , Wo          , Wo          , Wo          , Wo          , Wo          , Ww          , Ww          , Ww          , Ww          , Ds          , Ce          , Ce          , 1 Ke        , Ce          , Gg          , Ggf         , Gg          , Re^Vct      , Gg          , Gg          , Ds          , Gg          , Dd^Vdt      , Gg          , Gg          , Gg          , Gg          , Gs^Fp       , Gg          , Gg^Vl       , Gg          , Gg          , Gg          , Gg          
Gs^Fp       , Ss          , Gs^Fdw      , Ss          , Ss          , Cud         , Ss          , Ss          , Ss          , Gs^Fdw      , Ss          , Ss          , Ds          , Ds          , Ww          , Ww          , Ww          , Ww          , Wo          , Ww          , Wo          , Wo          , Wo          , Wo          , Wo          , Wo          , Wo          , Wo          , Wo          , Wo          , Wo          , Wo          , Wo          , Wo          , Wo          , Ww          , Ww          , Ds          , Ds          , Ce          , Ce          , Ce          , Gg          , Gg          , Gg          , Gg          , Ds          , Ds          , Ww          , Ds          , Ww          , Ds          , Ds          , Gs^Fdw      , Ds          , Gg          , Gg          , Gg          , Gg          , Gg          , Ds          , Gg          
Ww          , Ss          , Ss          , Ss          , Ss          , Ss          , Gs^Fdw      , Gs^Fdw      , Ss          , Ss          , Ww          , Ww          , Ww          , Ww          , Ww          , Ww          , Wo          , Wo          , Wo          , Wo          , Wo          , Wo          , Wo          , Wo          , Wo          , Wo          , Wo          , Wo          , Wo          , Wo          , Wo          , Wo          , Wo          , Wo          , Wo          , Wo          , Wo          , Ww          , Ww          , Ds          , Ds          , Gg          , Ds          , Gg          , Ds          , Ds          , Ww          , Ww          , Wo          , Ww          , Wo          , Ww          , Ww          , Ds          , Ds          , Ds          , Ds          , Ds          , Ds          , Ds          , Ww          , Ds          
Ww          , Ww          , Ww          , Ww          , Ww          , Ww          , Ww          , Ww          , Ww          , Ww          , Ww          , Ww          , Wo          , Ww          , Wo          , Wo          , Wo          , Wo          , Wo          , Wo          , Wo          , Wo          , Wo          , Wo          , Wo          , Wo          , Wo          , Wo          , Wo          , Wo          , Wo          , Wo          , Wo          , Wo          , Wo          , Wo          , Wo          , Wo          , Wo          , Ww          , Ww          , Ds          , Ww          , Ds          , Ww          , Ww          , Wo          , Wo          , Wo          , Wo          , Wo          , Wo          , Wo          , Ww          , Ww          , Ww          , Ww          , Ww          , Ww          , Ww          , Ww          , Ww          
Wo          , Ww          , Wo          , Wo          , Wo          , Ww          , Wo          , Wo          , Wo          , Wo          , Wo          , Wo          , Wo          , Wo          , Wo          , Wo          , Wo          , Wo          , Wo          , Wo          , Wo          , Wo          , Wo          , Wo          , Wo          , Wo          , Wo          , Wo          , Wo          , Wo          , Wo          , Wo          , Wo          , Wo          , Wo          , Wo          , Wo          , Wo          , Wo          , Ww          , Ww          , Ww          , Ww          , Ww          , Ww          , Wo          , Ww          , Ww          , Ds          , Gg^Vc       , Wo          , Wo          , Wo          , Ww          , Wo          , Wo          , Wo          , Ww          , Wo          , Wo          , Wo          , Wo          
Wo          , Wo          , Wo          , Wo          , Wo          , Wo          , Wo          , Wo          , Wo          , Wo          , Wo          , Wo          , Wo          , Wo          , Wo          , Wo          , Wo          , Wo          , Wo          , Wo          , Wo          , Wo          , Wo          , Wo          , Wo          , Wo          , Wo          , Wo          , Wo          , Wo          , Wo          , Wo          , Wo          , Wo          , Wo          , Wo          , Wo          , Wo          , Wo          , Wo          , Wo          , Wo          , Ww          , Ww          , Ww          , Ww          , Wo          , Wo          , Wo          , Ds          , Wo          , Wo          , Wo          , Wo          , Wo          , Wo          , Wo          , Wo          , Wo          , Wo          , Wo          , Wo          
